111111111
100C00C01
1CEP00001
100000C01
1000C0C01
111111111