111111111111
10C1000E1111
10110P001111
100001101111
100001001111
100000000001
110011110001
1C000C1C0001
111111111111
