111111111111
10C1000E1111
1011P0001111
100001101111
10C001C01111
100000000001
110011110001
1000001CC001
111111111111
