111111111111111111
100C1000000001C001
101110000000011101
10000000P000000001
101111110000111001
100C1E0000001C0001
111111111111111111